6	64
32	32
0	0	0	0	0	0	0	0	0	0	0	0	0	0	0	0	0	0	0	0	0	0	0	0	0	0	0	0	0	0	0	0	0	0	0	0	0	0	0	0	0	0	0	0	0	0	0	0	0	0	0	0	0	0	0	0	0	0	0	0	0	0	0	0	
1	2	3	4	5	6	7	7	8	9	7	7	7	7	8	9	7	7	8	9	7	7	2	5	6	8	9	7	8	9	2	3	10	4	3	7	7	8	9	7	7	8	9	7	7	7	7	7	7	7	7	7	7	11	7	8	9	7	7	11	7	7	8	9	
12	13	14	15	15	16	11	7	17	18	19	20	18	20	21	7	7	11	7	7	7	7	13	15	16	7	7	7	7	7	13	14	14	15	14	16	11	7	7	7	7	7	7	11	7	7	22	23	8	9	17	18	20	24	17	19	18	20	21	8	9	7	7	7	
25	26	27	28	28	29	30	31	32	32	32	33	32	33	34	35	36	37	38	39	40	41	26	28	29	7	22	42	42	23	26	27	27	28	27	29	30	36	43	7	22	42	23	7	7	43	44	45	30	31	32	32	33	32	33	32	32	33	34	36	37	38	40	39	
46	47	47	47	47	47	47	47	47	47	47	47	47	47	47	47	47	47	47	47	47	47	47	47	47	43	44	48	48	45	47	47	47	47	47	47	47	47	49	47	44	48	45	47	43	49	44	45	47	47	47	47	47	47	47	47	47	47	47	47	47	47	47	47	
50	51	51	51	51	51	51	51	51	51	51	51	51	51	51	51	52	53	54	53	54	53	54	53	54	55	56	57	57	58	53	53	59	60	53	61	51	51	51	51	51	51	51	52	55	55	56	58	53	53	62	53	62	53	62	53	61	51	51	51	51	51	51	51	
