3 3 3 3 3 3 3 3 3 3 3 3 3 3 3 3 3 3 3 3 3 3 3 3 3 3 3 3 3 3 3 3 3 3 3 3 3 3 3 3 3 3 3 3 3 3 3 3 3 3 3 3 3 3 3 3 3 3 3 3 3 3 3 3 3 3 3 3 3 3 3 3 3 3 3 3 3 3 3 3 3 3 3 3 3 3 3 3 3 3 3 3 3 3 3 3 3 3 3 3 3 3 3 3 3 3 3 3 3 3 3 3 3 3 3 3 3 3 3 3 3 3 3 3 3 3 3 3 3 3 3 3 3 3 3 3 3 3 3 3 3 3 3 3 3 3 3 3 3 3 3 3 3 3 3 3 3 3 3 3 
3 3 3 3 3 3 3 3 3 3 3 3 3 3 3 3 3 3 3 3 3 3 3 3 3 3 3 3 3 3 3 3 3 3 3 3 3 3 3 3 3 3 3 3 3 3 3 3 3 3 3 3 3 3 3 3 3 3 3 3 3 3 3 3 3 3 3 3 3 3 3 3 3 3 3 3 3 3 3 3 3 3 3 3 3 3 3 3 3 3 3 3 3 3 3 3 3 3 3 3 3 3 3 3 3 3 3 3 3 3 3 3 3 3 3 3 3 3 3 3 3 3 3 3 3 3 3 3 3 3 3 3 3 3 3 3 3 3 3 3 3 3 3 3 3 3 3 3 3 3 3 3 3 3 3 3 3 3 3 3 
295 163 163 301 163 163 163 301 324 301 324 163 163 163 163 163 163 163 163 163 163 163 163 163 163 163 163 163 163 163 163 163 163 163 163 163 163 163 163 163 163 163 163 163 163 301 324 301 324 163 163 163 163 163 163 163 163 163 163 163 163 301 163 163 163 163 163 301 163 163 163 163 163 163 163 163 163 163 163 163 163 163 163 163 163 163 163 163 163 163 163 163 163 163 163 163 163 163 163 163 163 163 163 163 163 163 163 163 163 163 163 163 163 163 163 163 163 163 163 163 163 163 163 163 163 163 163 163 3 325 326 327 328 329 330 331 332 333 334 335 336 337 338 339 340 341 342 343 344 345 346 347 348 349 3 3 3 3 3 3 
259 295 163 296 297 298 163 299 300 296 300 163 163 163 163 163 163 222 228 223 163 163 163 163 163 163 163 163 163 222 228 223 163 163 163 163 163 222 228 223 163 163 163 163 163 296 300 296 300 163 163 222 228 223 163 163 163 222 228 223 163 296 297 298 301 298 163 299 297 298 163 163 163 163 163 222 228 223 163 163 163 163 163 222 228 223 163 163 163 163 163 163 163 163 163 163 163 163 163 163 163 163 163 163 163 163 222 223 163 163 163 222 228 223 163 163 163 163 222 223 163 163 163 163 163 222 228 223 3 265 302 267 303 304 305 306 307 308 309 310 311 312 313 3 314 315 316 317 318 319 320 321 322 323 3 3 3 3 3 3 
259 260 163 261 262 263 264 188 264 188 264 163 163 163 163 163 163 193 193 194 193 163 195 196 193 194 195 196 163 163 163 163 163 163 163 163 163 163 163 163 163 163 163 163 163 261 264 188 264 163 163 163 163 163 163 163 163 163 163 163 163 261 262 263 262 263 264 188 262 263 264 163 163 163 163 163 163 163 163 163 163 163 163 163 163 163 163 163 163 163 163 163 68 75 75 69 163 163 163 163 163 193 193 194 195 196 193 163 163 193 193 163 193 194 195 196 163 163 163 163 163 163 163 163 163 163 163 163 3 265 266 267 268 269 270 271 272 273 274 275 276 277 278 3 279 280 281 282 283 284 285 286 287 288 289 290 291 292 293 294 
219 187 163 188 190 220 221 188 221 188 221 163 222 223 163 163 195 224 225 225 225 226 224 227 225 225 224 227 196 163 163 163 163 163 222 223 163 163 163 163 163 163 163 163 163 188 221 188 221 163 163 163 163 163 163 163 163 163 163 163 163 188 190 220 190 220 221 188 190 220 221 163 222 223 163 163 163 163 163 163 163 163 163 163 163 163 222 223 163 163 163 163 72 73 73 74 163 222 228 223 195 224 225 225 224 227 225 196 195 224 225 226 225 225 224 227 196 163 163 222 228 223 163 163 163 163 163 163 3 229 230 231 232 233 234 235 236 237 238 239 240 241 242 3 243 244 245 246 247 248 249 250 251 252 253 254 255 256 257 258 
147 187 163 188 189 190 191 188 191 188 191 163 163 163 163 158 160 159 160 159 160 159 159 192 160 159 159 192 160 162 163 163 163 163 163 193 193 194 195 196 163 194 163 163 163 188 191 188 191 163 163 163 68 75 75 75 75 75 75 69 163 188 189 190 189 190 191 188 189 190 191 163 163 163 163 163 68 69 163 163 68 75 75 75 75 69 163 163 163 163 68 69 72 73 73 74 163 163 163 158 160 159 160 159 159 192 160 159 159 192 160 159 160 159 159 192 160 162 163 163 163 193 193 194 163 194 195 196 3 3 197 198 199 200 3 3 3 201 3 202 203 3 3 3 204 205 206 207 208 209 210 211 212 213 214 215 216 217 218 3 
147 148 149 150 151 152 153 152 153 152 154 155 149 150 150 156 157 156 157 156 157 156 151 157 157 156 151 157 157 156 154 150 154 155 158 159 160 160 159 159 161 160 162 163 149 150 153 152 154 155 163 163 72 73 73 73 73 73 73 74 149 150 151 152 151 152 153 152 151 152 154 155 149 150 154 155 72 74 163 163 72 73 73 73 73 74 163 163 163 163 72 74 72 73 73 74 149 150 150 156 157 156 157 156 151 157 157 156 151 157 157 156 157 156 151 157 157 156 154 155 158 159 160 160 161 160 159 159 3 3 164 165 166 167 3 3 3 168 169 170 171 3 3 3 172 173 174 175 176 177 178 179 180 181 182 183 184 185 186 3 
121 96 122 122 122 122 122 122 122 122 122 122 122 122 122 122 122 122 122 122 122 122 122 122 122 122 122 122 122 122 122 122 122 122 122 122 122 122 122 122 122 122 122 122 122 122 122 122 122 122 68 69 72 73 73 73 73 73 73 74 122 122 122 122 122 122 122 122 122 122 122 122 122 122 122 122 70 71 122 122 72 73 73 73 73 74 122 122 68 69 70 71 72 73 73 74 122 122 122 122 122 122 122 122 122 122 122 122 122 122 122 122 122 122 122 122 122 122 122 122 122 122 122 122 122 122 122 122 3 3 123 124 125 126 3 3 3 127 128 129 130 131 3 3 132 133 134 135 136 137 138 139 140 141 142 143 144 145 146 3 
95 96 1 1 1 1 1 1 1 1 1 1 1 1 1 1 1 1 1 1 1 1 1 1 1 1 1 1 1 1 1 1 1 1 1 1 1 1 1 1 1 1 1 1 1 1 1 1 1 1 72 74 72 73 73 73 73 73 73 74 1 1 1 1 1 1 1 1 1 1 1 1 1 1 1 1 72 74 1 1 72 73 73 73 73 74 1 1 72 74 72 74 72 73 73 74 1 1 1 1 1 1 1 1 1 1 1 1 1 1 1 1 1 1 1 1 1 1 1 1 1 1 1 1 1 1 1 1 3 3 3 97 98 99 100 101 3 102 103 104 105 106 3 3 107 108 109 110 111 112 113 114 115 116 117 118 119 120 3 3 
65 29 66 66 66 66 66 66 66 66 66 66 66 66 66 66 66 66 66 66 66 66 66 66 66 66 66 66 66 66 66 66 66 67 1 1 68 69 1 1 68 69 1 1 68 69 1 1 68 69 70 71 72 73 73 73 73 73 73 74 1 1 1 1 68 75 75 69 1 1 76 66 66 66 66 66 66 66 66 66 66 66 66 66 66 66 66 67 70 71 70 71 72 73 73 74 1 1 1 1 77 1 1 1 77 1 1 1 77 1 1 1 76 66 66 66 66 66 66 66 66 66 66 66 66 66 66 66 3 3 3 3 3 3 78 79 3 3 3 3 3 3 3 3 80 81 82 83 84 85 86 87 88 89 90 91 92 93 94 3 
29 29 30 30 30 30 30 30 30 30 30 30 30 30 30 30 30 30 30 30 30 30 30 30 30 30 30 30 30 30 30 30 30 31 1 1 32 33 1 1 32 33 1 1 32 33 1 1 32 33 32 33 32 34 34 34 34 34 34 33 1 1 1 1 32 34 32 33 1 1 35 30 30 30 30 30 30 30 30 30 30 30 30 30 30 30 30 31 32 33 32 33 32 34 34 33 1 1 1 1 36 1 1 1 36 1 1 1 36 1 1 1 35 30 30 30 30 30 30 30 30 30 30 30 30 30 30 30 3 3 37 38 39 40 41 42 43 44 45 46 47 48 3 3 49 50 51 52 53 54 55 56 57 58 59 60 61 62 63 64 
0 0 0 0 0 0 0 0 0 0 0 0 0 0 0 0 0 0 0 0 0 0 0 0 0 0 0 0 0 0 0 0 0 0 1 1 1 1 1 1 1 1 1 1 1 1 1 1 1 1 1 1 1 1 1 1 1 1 1 1 1 1 1 1 1 1 1 1 1 1 2 0 0 0 0 0 0 0 0 0 0 0 0 0 0 0 0 0 1 1 1 1 1 1 1 1 1 1 1 1 1 1 1 1 1 1 1 1 1 1 1 1 2 0 0 0 0 0 0 0 0 0 0 0 0 0 0 0 3 3 4 5 6 7 8 9 10 11 12 13 14 15 3 3 16 17 18 19 20 21 22 23 24 25 26 27 28 3 3 3