0 0 0 0 0 0 0 0 0 0 0 0 0 0 0 0 0 0 0 0 0 0 0 0 0 0 0 0 0 0 0 0 0 0 0 0 0 0 0 0 0 0 0 0 0 0 0 0 0 0 0 0 0 0 0 0 0 0 0 0 0 0 0 0 0 0 0 0 0 0 0 0 0 0 0 0 0 0 0 0 
1 2 3 4 5 6 7 7 8 9 7 7 7 7 8 9 7 7 8 9 7 7 2 5 6 8 9 7 8 9 2 3 10 4 3 7 7 8 9 7 7 8 9 7 7 7 7 7 7 7 7 7 7 11 7 8 9 7 7 11 7 7 8 9 12 13 14 15 16 17 18 19 20 21 22 23 24 0 0 0 
25 26 27 28 28 29 11 7 30 31 32 33 31 33 34 7 7 11 7 7 7 7 26 28 29 7 7 7 7 7 26 27 27 28 27 29 11 7 7 7 7 7 7 11 7 7 35 36 8 9 30 31 33 37 30 32 31 33 34 8 9 7 7 7 38 39 40 41 42 43 44 45 46 47 48 49 50 51 52 53 
54 55 56 57 57 58 59 60 61 61 61 62 61 62 63 64 65 66 67 68 69 70 55 57 58 7 35 71 71 36 55 56 56 57 56 58 59 65 72 7 35 71 36 7 7 72 73 74 59 60 61 61 62 61 62 61 61 62 63 65 66 67 69 68 0 75 76 0 77 78 79 0 80 81 82 83 84 85 86 87 
88 89 89 89 89 89 89 89 89 89 89 89 89 89 89 89 89 89 89 89 89 89 89 89 89 72 73 90 90 74 89 89 89 89 89 89 89 89 91 89 73 90 74 89 72 91 73 74 89 89 89 89 89 89 89 89 89 89 89 89 89 89 89 89 0 92 93 94 95 96 97 0 98 99 100 101 102 103 104 105 
106 107 107 107 107 107 107 107 107 107 107 107 107 107 107 107 108 109 110 109 110 109 110 109 110 111 112 113 113 114 109 109 115 116 109 117 107 107 107 107 107 107 107 108 111 111 112 114 109 109 118 109 118 109 118 109 117 107 107 107 107 107 107 107 0 119 120 121 122 123 124 0 125 126 127 128 129 130 131 132